WWWWWWWWWWWWWWWWWWWW
W0F00MW00FF00WM00F0W
W0F00MWWMMMMMWM00F0W
W000000000000000000W
W000000000000F00000W
W000MM0000M00000000W
W000000M00000000000W
W00M00000F0000000WWW
W0000000000000WWW00W
W000000000000000000W
W0M00WW0WWW00000000W
W0000W00F0W00000000W
W0P00W0M00W00000000W
W0000WWWWWW00000F00W
W0M0000000000000000W
W000000000000000000W
W0F0000000000F00M00W
W0WWWW0000000000000W
W00F00WWWW000000WWWW
WWWWWWWWWWWWWWWWWWWW
